+++ +++++++++
+ +     + + +
+ + +++ + + +
+ + +     + + 
+ + +++++ + +
+ + +     + +
+ + +     + +
+ +   +   + +
+ +   +   +++
+++++ +++++++
+   +   ++ ++
+ + + ++++ ++
+ +     ++ ++
+ +++   ++ ++
+ +     ++ ++
+ +   ++++ ++
+   S   ++ ++
+++++++ +++++
++ ++   + + +
++ ++++ + + +
++ ++       + 
++ ++ +++++ + 
++ ++ +     +
++ ++       +
+++++++++++++