++++++++++++++++++++++++++++++
+  +                          
+   ++++                     +
+       +                    +
+   ++++                     +
+  +                         +
+  +                         +
+  +                  +++    +
+  +               +++ +     +
+  +             ++   +      +
+  +           ++   ++       +
+ +          ++   ++         +
++         ++   ++           +
+        ++   ++           +++
+        +++++           ++  +
+                      ++    +
+                    ++      +
+                  ++        +
+S                 +         +
++++++++++++++++++++++++++++++