++++++++++++++++++++++++++++++
+                            +
+                            +
+                            +
+                  ++        +
+                  ++        +
+       W          ++        +
+                  ++        +
+                  ++        +
+                  ++        +
+                  ++        +
+    ++++++++++++            +
+    ++++++++++++            +
+                            +
+                            +
+                            +
+                            +
+                            +
+S                           +
++++++++++++++++++++++++++++++