+++++++++++++
+           +
+           +
+  +++++++  +
+  +     S  +
+  +  ++++  +
+  +     +  +
+  +++++++  +
+           +
            +
+++++++++++++
