++++++++++++++++++++++
+       ++ ++   +    +
  +++++ ++ +  +++    +
+      +   +  +      +
+ +++++   +  +       +
+        +   +       +
+ +++++++     +      +
+       +     +++++  +
+ ++++++++++   +   + +
+               S  + +
++++++++++++++++++++++