+++++++++++
+         +
+ +++++++ +
+ +     S +
+ +  ++++ +
+ +     + +
+ +++++++ +
          +
+++++++++++
